----------
--k-------
--k-------
--k-------
--k-------
------k---
--kkk-k---
------k---
k---------
k-kk------